opac|opacity|around
decry|decrypt|around
data|data|around
f|foo|around
b|btoa|around
lo|log|tsserver-javascript
conso|console|tsserver-javascript
a|a|tsserver-javascript
bto|btoa|tsserver-javascript
nvi|nvim|around
nvi|nvim|file
printf|printf|languageserver.ccls
inclu|include|languageserver.ccls
stdi|stdio.h>|languageserver.ccls
inc|include|languageserver.ccls
ip|ipv4|around
mixe|mixer|around
dev|dev|file
vo|vol_perc|around
NULL|NULL|around
dis|disk_used|around
class_|class_g|around
main|main.h"|languageserver.ccls
incl|include|languageserver.ccls
include|include|languageserver.ccls
stdio|stdio.h>|languageserver.ccls
iostre|iostream>|languageserver.ccls
prin|println!|rust-analyzer
fn|fn|rust-analyzer
print|println!|rust-analyzer